 _____ _                 _            ______            ______ _             _                _ 
|_   _| |               | |           |  ___|           | ___ \ |           (_)              | |
  | | | |__   __ _ _ __ | | _____     | |_ ___  _ __    | |_/ / | __ _ _   _ _ _ __   __ _   | |
  | | | '_ \ / _` | '_ \| |/ / __|    |  _/ _ \| '__|   |  __/| |/ _` | | | | | '_ \ / _` |  | |
  | | | | | | (_| | | | |   <\__ \    | || (_) | |      | |   | | (_| | |_| | | | | | (_| |  |_|
  \_/ |_| |_|\__,_|_| |_|_|\_\___/    \_| \___/|_|      \_|   |_|\__,_|\__, |_|_| |_|\__, |  (_)
                                                                        __/ |         __/ |     
                                                                       |___/         |___/      