  ___   _   _ _____ ___________  ___  ______ _____ _____ _____  _      _____       ___  ___  ___   ______ _____ 
 / _ \ | \ | |_   _|_   _| ___ \/ _ \ | ___ \_   _|_   _/  __ \| |    |  ___|      |  \/  | / _ \ |___  /|  ___|
/ /_\ \|  \| | | |   | | | |_/ / /_\ \| |_/ / | |   | | | /  \/| |    | |__        | .  . |/ /_\ \   / / | |__  
|  _  || . ` | | |   | | |  __/|  _  ||    /  | |   | | | |    | |    |  __|       | |\/| ||  _  |  / /  |  __| 
| | | || |\  | | |  _| |_| |   | | | || |\ \  | |  _| |_| \__/\| |____| |___       | |  | || | | |./ /___| |___ 
\_| |_/\_| \_/ \_/  \___/\_|   \_| |_/\_| \_| \_/  \___/ \____/\_____/\____/       \_|  |_/\_| |_/\_____/\____/ 
                                                                                                                
                                                                                                                