P 1 K 0 0 - 0 0 
0 0 0 0 1 0 0 0 
+ 0 1 1 0 1 0 0 
0 0 1 0 K 0 0 0 
0 1 1 e 0 1 0 X 
0 0 0 0 0 0 0 0 
K 0 0 0 1 1 1 0 
0 1 1 0 0 0 C K