0 1 0 X 0 1 0 - 0 0 
0 e 0 1 0 0 0 1 0 + 
1 1 0 0 1 K 0 1 0 1 
0 P 0 0 0 0 0 C 1 0 
0 0 + 0 1 1 0 0 0 K 
K 1 1 0 P 0 0 1 - 0 
0 0 1 1 0 1 0 1 1 1 
1 0 0 e 0 0 0 0 0 0 